###############
#***...R......#
#***... ...*..#
#\\\... ..\\\.#
#...... ...*..#
#.... .. .....#
#.\.. .......*#
#.............#
#.........   .#
#############L#
